{
	0x01, 0x01, 0xff, 0xfe, 0x00, 0x03, 0x88, 0x78, 0x00, 0x0f, 0xff, 0xe0, 0x00, 0x00, 0x00, 0x00, 0x00, 0x00, 0x00, 0x00, 0x00, 0x00, 0x00, 0x00, 0x00, 0x00, 0x00, 0x00, 0x00, 0x00, 0x00, 0x00, 0x00, 0x00, 0x00, 0x00, 0x00, 0x00, 0x00, 0x00,
	0x02, 0x03, 0xff, 0xf0, 0x00, 0x03, 0x83, 0xc0, 0x00, 0x0e, 0x07, 0xfc, 0x00, 0x3d, 0x00, 0x70, 0x00, 0xe0, 0x41, 0xc0, 0x03, 0x81, 0xff, 0x00, 0x0f, 0xff, 0x00, 0x00, 0x00, 0x00, 0x00, 0x00, 0x00, 0x00, 0x00, 0x00, 0x00, 0x00, 0x00, 0x00,
	0x03, 0x02, 0xff, 0xff, 0xc0, 0x03, 0x80, 0x07, 0x00, 0x0e, 0x38, 0x1c, 0x00, 0x38, 0x94, 0x70, 0x00, 0xe0, 0xd1, 0xc0, 0x03, 0x80, 0x07, 0x00, 0x0f, 0xff, 0xfc, 0x00, 0x00, 0x00, 0x00, 0x00, 0x00, 0x00, 0x00, 0x00, 0x00, 0x00, 0x00, 0x00,
	0x06, 0x04, 0x03, 0xff, 0xc0, 0x03, 0xfe, 0x07, 0xff, 0x8e, 0x00, 0x02, 0x0e, 0x38, 0xe0, 0x78, 0x38, 0xe0, 0x83, 0xc0, 0xe3, 0xff, 0xff, 0xff, 0x80, 0x00, 0x00, 0x00, 0x00, 0x00, 0x00, 0x00, 0x00, 0x00, 0x00, 0x00, 0x00, 0x00, 0x00, 0x00,
	0x06, 0x02, 0xff, 0xff, 0xff, 0x03, 0x80, 0x00, 0x1c, 0x0e, 0x0d, 0xb0, 0x70, 0x38, 0x00, 0x01, 0xc0, 0xff, 0xfe, 0x07, 0x00, 0x00, 0x3f, 0xfc, 0x00, 0x00, 0x00, 0x00, 0x00, 0x00, 0x00, 0x00, 0x00, 0x00, 0x00, 0x00, 0x00, 0x00, 0x00, 0x00,
	0x04, 0x03, 0x1f, 0xff, 0xff, 0x00, 0x70, 0x00, 0x1c, 0x01, 0xc1, 0x84, 0x70, 0x3f, 0x10, 0x41, 0xc0, 0xe0, 0x18, 0x47, 0x03, 0x80, 0x00, 0x1c, 0x0f, 0xff, 0xff, 0xf0, 0x00, 0x00, 0x00, 0x00, 0x00, 0x00, 0x00, 0x00, 0x00, 0x00, 0x00, 0x00,
	0x02, 0x01, 0xff, 0xfe, 0x00, 0x03, 0x80, 0x38, 0x00, 0x0e, 0x49, 0xe0, 0x00, 0x3c, 0x93, 0xf0, 0x00, 0xe0, 0x01, 0xc0, 0x03, 0x80, 0x07, 0x00, 0x0f, 0xff, 0xfc, 0x00, 0x00, 0x00, 0x00, 0x00, 0x00, 0x00, 0x00, 0x00, 0x00, 0x00, 0x00, 0x00
}