{
	0x49, 0x24, 0x00, 0x01, 0x18, 0xd0, 0x00, 0x04, 0x92, 0x40, 0x00, 0x00, 0x00, 0x00, 0x00, 0x00, 0x00, 0x00, 0x00, 0x00, 0x00, 0x00, 0x00, 0x00, 0x00, 0x00, 0x00, 0x00, 0x00, 0x00, 0x00, 0x00, 0x00, 0x00, 0x00, 0x00, 0x00, 0x00,
	0x49, 0x20, 0x00, 0x01, 0x06, 0x80, 0x00, 0x04, 0x02, 0x48, 0x00, 0x16, 0x20, 0x20, 0x00, 0x40, 0x40, 0x80, 0x01, 0x00, 0x92, 0x00, 0x04, 0x92, 0x00, 0x00, 0x00, 0x00, 0x00, 0x00, 0x00, 0x00, 0x00, 0x00, 0x00, 0x00, 0x00, 0x00,
	0x49, 0x24, 0x80, 0x01, 0x00, 0x02, 0x00, 0x04, 0x11, 0x08, 0x00, 0x10, 0x98, 0x20, 0x00, 0x41, 0xe0, 0x80, 0x01, 0x00, 0x02, 0x00, 0x04, 0x92, 0x48, 0x00, 0x00, 0x00, 0x00, 0x00, 0x00, 0x00, 0x00, 0x00, 0x00, 0x00, 0x00, 0x00,
	0x01, 0x24, 0x80, 0x01, 0x24, 0x02, 0x49, 0x04, 0x00, 0x02, 0x04, 0x10, 0x40, 0x28, 0x10, 0x41, 0x86, 0x88, 0x41, 0x24, 0x92, 0x49, 0x00, 0x00, 0x00, 0x00, 0x00, 0x00, 0x00, 0x00, 0x00, 0x00, 0x00, 0x00, 0x00, 0x00, 0x00, 0x00,
	0x49, 0x24, 0x92, 0x01, 0x00, 0x00, 0x08, 0x04, 0x1e, 0xd0, 0xa0, 0x10, 0x00, 0x00, 0x80, 0x49, 0x24, 0x02, 0x00, 0x00, 0x12, 0x48, 0x00, 0x00, 0x00, 0x00, 0x00, 0x00, 0x00, 0x00, 0x00, 0x00, 0x00, 0x00, 0x00, 0x00, 0x00, 0x00,
	0x09, 0x24, 0x92, 0x00, 0x20, 0x00, 0x08, 0x00, 0x83, 0x8c, 0x20, 0x12, 0x10, 0xc0, 0x80, 0x40, 0x38, 0xc2, 0x01, 0x00, 0x00, 0x08, 0x04, 0x92, 0x49, 0x20, 0x00, 0x00, 0x00, 0x00, 0x00, 0x00, 0x00, 0x00, 0x00, 0x00, 0x00, 0x00,
	0x49, 0x24, 0x00, 0x01, 0x02, 0x10, 0x00, 0x04, 0xdb, 0x40, 0x00, 0x14, 0x91, 0x20, 0x00, 0x40, 0x00, 0x80, 0x01, 0x00, 0x02, 0x00, 0x04, 0x92, 0x48, 0x00, 0x00, 0x00, 0x00, 0x00, 0x00, 0x00, 0x00, 0x00, 0x00, 0x00, 0x00, 0x00
}