{
	0x03, 0x04, 0x00, 0x00, 0x00, 0x00, 0x00, 0x00, 0x00, 0x00, 0x00, 0x00, 0x00, 0x00, 0xff, 0xfe, 0x00, 0x03, 0x88, 0x78, 0x00, 0x0f, 0xff, 0xe0, 0x00, 0x00, 0x00, 0x00, 0x00, 0x00, 0x00, 0x00, 0x00, 0x00, 0x00, 0x00, 0x00, 0x00, 0x00, 0x00,
	0x04, 0x04, 0x00, 0x00, 0x00, 0x00, 0x0f, 0xff, 0x00, 0x00, 0x38, 0x3c, 0x00, 0x00, 0xe0, 0x7f, 0xc0, 0x03, 0xd0, 0x07, 0x00, 0x0e, 0x04, 0x1c, 0x00, 0x38, 0x1f, 0xf0, 0x00, 0xff, 0xf0, 0x00, 0x00, 0x00, 0x00, 0x00, 0x00, 0x00, 0x00, 0x00,
	0x05, 0x03, 0x00, 0x00, 0x00, 0x00, 0x0f, 0xff, 0xfc, 0x00, 0x38, 0x00, 0x70, 0x00, 0xe3, 0x81, 0xc0, 0x03, 0x89, 0x47, 0x00, 0x0e, 0x0d, 0x1c, 0x00, 0x38, 0x00, 0x70, 0x00, 0xff, 0xff, 0xc0, 0x00, 0x00, 0x00, 0x00, 0x00, 0x00, 0x00, 0x00,
	0x06, 0x06, 0x00, 0x00, 0x00, 0x00, 0x00, 0x00, 0x00, 0x00, 0x3f, 0xfc, 0x00, 0x3f, 0xe0, 0x7f, 0xf8, 0xe0, 0x00, 0x20, 0xe3, 0x8e, 0x07, 0x83, 0x8e, 0x08, 0x3c, 0x0e, 0x3f, 0xff, 0xff, 0xf8, 0x00, 0x00, 0x00, 0x00, 0x00, 0x00, 0x00, 0x00,
	0x07, 0x04, 0x00, 0x00, 0x00, 0x00, 0x00, 0x00, 0x00, 0x01, 0xff, 0xff, 0xfe, 0x07, 0x00, 0x00, 0x38, 0x1c, 0x1b, 0x60, 0xe0, 0x70, 0x00, 0x03, 0x81, 0xff, 0xfc, 0x0e, 0x00, 0x00, 0x7f, 0xf8, 0x00, 0x00, 0x00, 0x00, 0x00, 0x00, 0x00, 0x00,
	0x05, 0x04, 0x00, 0x00, 0x00, 0x00, 0x0f, 0xff, 0xff, 0x80, 0x38, 0x00, 0x0e, 0x00, 0xe0, 0xc2, 0x38, 0x1f, 0x88, 0x20, 0xe0, 0x70, 0x0c, 0x23, 0x81, 0xc0, 0x00, 0x0e, 0x07, 0xff, 0xff, 0xf8, 0x00, 0x00, 0x00, 0x00, 0x00, 0x00, 0x00, 0x00,
	0x04, 0x02, 0x00, 0x00, 0x00, 0x00, 0x0f, 0xff, 0xe0, 0x00, 0x38, 0x03, 0x80, 0x00, 0xe4, 0x9e, 0x00, 0x03, 0xc9, 0x3f, 0x00, 0x0e, 0x00, 0x1c, 0x00, 0x38, 0x00, 0x70, 0x00, 0xff, 0xff, 0xc0, 0x00, 0x00, 0x00, 0x00, 0x00, 0x00, 0x00, 0x00
}